linhas 10
colunas 20
...............+++++
..........++++++++++
..........a+++++++++
...1.........+++++++
........2.....++++++
....+c...........b++
...++++..........+++
....++............++
.....3........!.....
..........4.........

